39 38 38 39 39 39 39 39 39 39 39 39 39 39 39 39
39 38 38 38 38 38 38 38 38 38 38 38 38 38 38 39
39 38 38 38 38 38 38 38 38 38 38 38 38 38 38 39
39 38 38 38 38 38 38 38 38 38 38 38 38 38 38 39
39 38 38 38 38 38 38 38 38 38 38 38 38 38 38 39
39 38 38 38 38 38 38 38 38 38 38 38 38 38 38 39
39 38 38 38 38 38 38 38 38 38 38 38 38 38 38 39
39 38 38 38 38 38 40 40 40 40 38 38 38 38 38 39
39 38 38 38 38 38 40 40 40 40 38 38 38 38 38 39
39 38 38 38 38 38 40 40 40 40 38 38 38 38 38 39
39 38 38 38 38 38 40 40 40 40 38 38 38 38 38 39
39 39 39 39 39 39 39 39 39 39 39 39 39 39 39 39
