19 19 19 19 19 19 19 19 19 19 19 19 19 19 19 19 19 19 19 19 19 19 19 19 19 19 19 19 19 19 19 19 19 19 19 19 19 19 19 19 19 19 19 19 19 19 19 19 19 19 
19 19 19 19 19 19 19 19 19 19 19 19 19 19 19 19 19 19 19 19 19 19 19 19 19 19 19 19 19 19 19 19 19 19 19 19 19 19 19 19 19 19 19 19 19 19 19 19 19 19 
19 19 19 19 19 19 19 19 19 19 19 19 19 19 19 19 19 19 19 19 19 19 19 19 19 19 19 19 19 19 19 19 19 19 19 19 19 19 19 19 19 19 19 19 19 19 19 19 19 19 
19 19 19 19 19 19 19 19 19 19 19 19 19 19 19 19 19 19 19 19 19 19 19 19 19 19 19 19 19 19 19 19 19 19 19 19 19 19 19 28 26 26 26 26 29 19 19 19 19 19 
19 19 19 19 19 19 19 19 19 19 19 19 19 19 19 19 19 19 19 19 19 19 19 19 19 19 19 19 19 19 19 19 19 19 19 19 19 19 28 27 44 44 44 44 25 26 29 19 19 19 
19 19 19 19 19 19 19 19 19 19 19 19 19 19 19 19 19 19 19 19 19 19 19 19 19 19 19 19 19 19 19 19 19 19 19 19 19 28 27 2 2 2 2 2 2 2 23 19 19 19 
19 19 19 19 19 19 28 26 26 26 26 26 26 26 26 26 26 26 26 26 26 26 26 26 26 26 26 29 19 19 19 19 19 19 19 28 26 27 44 2 44 44 44 44 44 2 23 19 19 19 
19 19 19 19 28 26 27 44 44 44 32 32 32 32 32 12 10 10 10 10 10 10 10 10 10 10 13 23 19 19 19 19 19 28 26 27 44 44 44 2 44 20 21 21 22 2 25 29 19 19 
19 19 19 19 24 44 44 44 44 44 32 17 17 17 32 8 3 3 3 3 3 3 3 3 3 3 7 25 26 26 26 26 26 27 44 44 44 44 44 2 20 31 360 360 24 2 44 23 19 19 
19 19 28 26 27 44 44 44 44 44 32 17 36 17 32 8 3 4 5 5 5 5 5 5 6 3 7 44 44 44 44 44 44 44 44 44 44 44 44 2 23 360 360 360 24 2 44 23 19 19 
19 19 24 44 44 44 44 44 44 44 32 17 17 17 32 8 3 7 329 330 331 338 340 341 8 3 7 20 21 21 21 21 22 44 44 44 44 44 44 2 23 360 360 360 30 22 44 23 19 19 
19 19 24 44 1 1 1 1 1 44 32 17 17 17 32 8 3 7 332 333 334 342 343 344 8 3 7 25 26 26 26 26 27 44 44 44 44 44 44 2 23 360 360 360 360 24 44 23 19 19 
19 19 24 44 1 44 44 44 1 44 32 32 17 32 32 8 3 7 335 336 337 345 346 347 8 3 9 10 10 10 10 10 10 10 10 10 10 10 10 13 23 360 360 360 360 24 44 23 19 19 
19 19 24 44 1 44 44 44 1 2 2 2 2 44 44 8 3 9 10 10 10 10 10 10 11 3 3 3 3 3 3 3 3 3 3 3 3 3 3 20 31 360 360 360 360 24 44 23 19 19 
19 19 24 44 1 44 44 44 44 44 44 44 44 44 44 8 3 3 3 3 3 3 3 3 3 3 4 5 5 5 5 6 3 4 5 5 5 6 3 23 360 360 360 360 28 27 44 23 19 19 
19 19 24 44 1 44 44 44 1 1 1 1 1 1 44 14 5 5 6 3 4 5 5 5 5 5 15 44 44 44 44 8 3 7 44 44 44 8 3 23 360 360 360 360 24 44 44 23 19 19 
19 19 24 44 1 44 44 44 1 44 44 44 44 1 44 44 44 44 8 3 7 44 44 44 44 44 44 44 44 44 44 8 3 9 10 10 10 11 3 25 26 26 26 26 27 44 44 23 19 19 
19 19 24 44 1 1 1 1 1 44 44 44 44 1 44 44 44 44 8 3 7 44 44 44 44 44 44 44 44 44 44 8 3 3 3 3 3 3 3 44 44 44 44 44 44 44 44 23 19 19 
19 19 24 44 44 44 44 44 44 44 44 44 44 1 44 44 1 44 8 3 7 327 328 328 328 328 328 328 328 328 339 8 3 4 5 5 5 6 3 9 10 10 10 13 44 44 44 23 19 19 
19 19 24 44 44 44 44 44 44 44 44 44 44 1 44 44 1 44 8 3 7 350 44 44 310 311 312 313 44 44 351 8 3 7 44 44 44 8 3 3 3 3 3 7 44 44 44 23 19 19 
19 19 24 44 44 1 1 1 1 1 1 1 1 1 1 1 1 44 8 3 7 350 44 2 314 315 316 317 2 44 351 8 3 7 2 2 44 8 3 4 5 6 3 7 44 44 44 23 19 19 
19 19 24 44 44 1 44 44 44 44 44 44 44 1 44 44 1 44 8 3 7 350 44 2 318 319 320 321 2 44 351 8 3 7 44 2 44 8 3 7 44 8 3 7 44 44 44 23 19 19 
19 19 24 44 44 1 44 1 1 1 1 1 44 1 44 44 1 44 8 3 7 350 44 2 322 323 324 325 2 44 351 8 3 7 44 2 44 8 3 9 10 11 3 9 10 13 44 23 19 19 
19 19 24 44 44 1 44 1 44 44 44 1 44 1 44 44 44 44 11 3 7 350 44 2 350 8 7 351 2 44 351 8 3 7 44 2 44 8 3 3 3 3 3 3 3 7 44 23 19 19 
19 19 24 44 44 1 44 44 44 44 44 1 44 1 2 2 2 2 3 3 7 352 44 44 353 8 7 352 44 44 353 8 3 7 44 2 44 8 3 4 5 5 5 6 3 7 44 23 19 19 
19 19 24 44 44 1 1 1 1 1 1 1 44 44 44 44 44 44 6 3 7 354 355 355 356 8 7 354 355 355 356 8 3 7 44 2 44 8 3 7 2 2 2 8 3 7 44 23 19 19 
19 19 24 44 44 44 44 44 44 44 44 44 44 44 44 44 44 44 8 3 9 2 44 44 2 8 7 2 44 44 2 8 3 7 44 44 44 8 3 7 2 2 2 8 3 7 44 23 19 19 
19 19 24 44 44 44 44 44 44 44 44 44 44 44 44 44 44 44 8 3 3 9 10 10 10 11 9 10 10 10 10 11 3 9 10 10 10 11 3 9 10 10 10 11 3 7 44 23 19 19 
19 19 30 21 21 21 21 21 21 21 21 21 21 21 21 21 21 22 44 6 3 3 3 3 3 3 3 3 3 3 3 3 3 3 3 3 3 3 3 3 3 3 3 3 3 7 44 23 19 19 
19 19 19 19 19 19 19 19 19 19 19 19 19 19 19 19 19 24 44 2 2 5 5 5 5 5 5 5 5 5 5 6 3 4 5 5 5 6 3 4 5 5 5 5 5 15 44 23 19 19 
19 19 19 19 19 19 19 19 19 19 19 19 19 19 19 19 19 24 44 2 2 44 44 44 44 44 44 44 44 44 44 8 3 7 338 340 341 8 3 7 329 330 331 44 44 44 44 23 19 19 
19 19 19 19 19 19 28 26 26 26 26 26 26 26 29 19 19 24 44 2 44 44 44 44 44 2 44 44 2 44 44 8 3 7 342 343 344 8 3 7 332 333 334 44 44 44 44 23 19 19 
19 19 19 19 19 19 24 44 329 330 331 44 44 44 23 19 19 24 44 44 44 44 44 44 44 44 44 44 44 44 44 8 3 7 345 346 347 8 3 7 335 336 337 44 44 44 44 23 19 19 
19 19 19 19 19 19 24 44 332 333 334 44 44 44 23 19 19 24 44 44 44 2 44 44 338 340 341 44 44 2 44 8 3 7 44 11 9 11 3 9 10 11 9 13 44 44 44 23 19 19 
19 19 19 19 19 19 24 44 335 336 337 348 349 44 25 26 26 27 44 44 44 44 44 44 342 343 344 44 44 44 44 8 3 7 44 3 3 3 3 3 3 3 3 7 44 44 44 23 19 19 
19 19 28 26 26 26 27 44 8 3 7 44 44 44 44 44 44 44 44 2 44 44 44 44 345 346 347 44 44 44 44 8 3 7 44 5 5 6 3 4 5 5 5 15 44 44 44 23 19 19 
19 19 24 44 44 44 44 44 8 3 7 44 44 44 2 44 44 44 44 44 44 44 12 10 10 11 9 10 10 10 10 11 3 7 329 330 331 8 3 7 338 340 341 20 21 21 21 31 19 19 
19 19 24 44 44 44 44 44 8 3 7 44 44 44 44 44 44 2 44 44 44 44 8 3 3 3 3 3 3 3 3 3 3 7 332 333 334 8 3 7 342 343 344 23 19 19 19 19 19 19 
19 19 24 44 12 10 10 10 11 3 9 10 10 10 10 10 10 10 10 10 10 10 11 3 4 5 5 5 5 5 5 6 3 7 335 336 337 8 3 7 345 346 347 23 19 19 19 19 19 19 
19 19 24 44 8 3 3 3 3 3 3 3 3 3 3 3 3 3 3 3 3 3 3 3 7 44 44 44 44 44 44 8 3 7 44 11 9 11 3 9 10 11 9 23 19 19 19 19 19 19 
19 19 24 44 8 3 4 5 5 5 5 6 3 4 5 5 5 5 5 6 3 4 5 5 20 21 21 21 21 22 44 8 3 7 44 3 3 3 3 3 3 3 3 23 19 19 19 19 19 19 
19 19 24 44 8 3 7 20 21 21 22 8 3 7 44 1 44 44 44 8 3 7 44 44 23 1 1 1 1 24 44 8 3 7 44 5 5 5 5 5 5 6 3 23 19 19 19 19 19 19 
19 19 24 44 8 3 7 25 26 26 27 8 3 7 44 1 1 44 44 8 3 9 13 44 23 1 1 1 1 24 44 8 3 7 44 44 44 44 44 44 44 8 3 23 19 19 19 19 19 19 
19 19 24 44 8 3 9 10 10 10 10 11 3 7 44 44 1 44 44 8 3 3 9 13 23 21 21 21 21 24 44 8 3 9 10 10 10 10 10 10 10 11 3 23 19 19 19 19 19 19 
19 19 24 44 8 3 3 3 3 3 3 3 3 7 44 44 1 1 44 14 6 3 3 7 25 26 26 26 26 27 12 11 3 3 3 3 3 3 3 3 3 3 3 23 19 19 19 19 19 19 
19 19 24 44 14 5 5 5 5 5 5 5 5 15 44 44 44 44 44 44 14 6 3 9 10 10 10 10 10 10 11 3 3 4 5 5 5 20 21 21 21 21 21 31 19 19 19 19 19 19 
19 19 24 44 44 44 44 44 44 44 44 44 44 44 44 44 44 44 44 44 44 8 3 3 3 3 3 3 3 3 3 3 20 21 21 21 21 31 19 19 19 19 19 19 19 19 19 19 19 19 
19 19 30 21 21 21 21 21 21 21 21 21 21 21 21 21 21 21 21 21 21 21 21 21 21 21 22 44 5 5 5 44 23 19 19 19 19 19 19 19 19 19 19 19 19 19 19 19 19 19 
19 19 19 19 19 19 19 19 19 19 19 19 19 19 19 19 19 19 19 19 19 19 19 19 19 19 24 44 1 1 1 44 23 19 19 19 19 19 19 19 19 19 19 19 19 19 19 19 19 19 
19 19 19 19 19 19 19 19 19 19 19 19 19 19 19 19 19 19 19 19 19 19 19 19 19 19 24 44 2 2 2 44 23 19 19 19 19 19 19 19 19 19 19 19 19 19 19 19 19 19 
